Замок людей

1. Крестьянин - Ополченец - Милиция
2. Пикинер - Алебардщик - Стражник
3. Лучник - Арбалетчик - Стрелок
4. Мечник - Крестоносец - Паладин
5. Монах - Фанатик - Инквизитор
6. Рыцарь - Кавалерист - Чемпион
7. Ангел - Архангел - Верховный архангел

Замок эльфов
1. Фея - Нимфа - Королева фей
2. Гном - Боевой гном - ?
3. Лесной эльф - Великий эльф - Снайпер
4. Пегас - Серебряный пегас - Золотой пегас
5. Грифон - Лесной грифон - Грифон-убийца
6. Единорог - Боевой единорог - Волшебный единорог
7. Зеленый дракон - Золотой дракон - Алмазный дракон

Замок магов
1. Гремлин - Мастер гремлин - Старший гремлин
2. Гаргулья - Железная гаргулья - Обсидиановая гаргулья
3. Каменный голем - Стальной голем - Обсидиановый голем
4. Маг - Архимаг - Чародей
5. Джинн - Мастер джинн - Джинн султан
6. Нага - Принцесса нага - Королева нага
7. Гигант - Титан - Громовержец
(стандартный набор 3, 5 героев)

Демоны
1. Бес - Чёрт - Квазит
2. Гог - Великий гог - Магог
3. Адская гончая - Огненная гончая - Цербер
4. Суккуб - Демоннеса - Искусительница
5. Демон - Рогатый демон - Огненный демон
6. Порождение Зла - Пещерное отродье - Адское отродье
7. Дьявол - Архидьявол - Барон Ада

Некрополис
1. Скелет - Костяной воитель - Скелет лучник
2. Ходячий труп - Зомби - Гниющий зомби
3. Дух - Призрак - Привидение
4. Упырь - Вурдалак - Умертвие
5. Вампир - Великий вампир - Вампир лорд
6. Лич - Могущественный лич - Архилич
7. Костяной дракон - Призрачный дракон - Кровавый дракон

Подземелье
1. Пещерная жаба - Троглодит - Адский троглодит
2. Гарпия - Свирепая гарпия - Гарпия ведьма
3. Созерцатель - Злой глаз - Глаз тьмы
4. Медуза - Медуза горгона - Королева медуза
5. Минотавр - Боевой минотавр - Король минотавр
6. Тёмный жеребец - Адский жеребец - Кошмар
7. Красный дракон - Чёрный дракон - Дракон тьмы

Убежище
1. Лазутчик - Ловчий - Ловчий дроу
2. Бестия - Фурия - Мегера
3. Ночной охотник - Драгазар - Проклятый драгазар
4. Драйдер - Дрион - Тёмный дрион
5. Сумеречная ведьма - Ведьма тьмы - Сумеречная заклинательница
6. Мантикора - Ядовитая мантикора - Скорпикора
7. Драеглот - Тёмный драеглот - Глабрезу 

Цитадель

1. Гоблин - Гоблин воин - Хобгоблин
2. Волчий всадник - Налетчик - ?
3. Кентавр - Кочевой кентавр - Боевой кентавр
4. Орк - Орк воин - Вождь орков
5. Огр - Огр лорд - Огр маг.
6. Циклоп - Свободный циклоп - Король циклопов
7. Чудище - Горное чудище - древнее чудище 